##########################
#........................#
#........................#
#...........##############
#........................#
#........................#
#...#########.............
#...........#.............
#...........#.............
#...x.......#.............
#...........#............#
#...........#.....#......#
#...........#.....#......#
#...###...........#......#
#.................#......#
#........................#
##########################