##########################
#........#..........#.....
#.########.....#....#.....
#.#......#..#..#.........#
#........#..#..###########
#.#########.#.........#..#
#.#.........#########.#..#
#.########..........#.#..#
#........#..###..####.#..#
#.x......#....#..#..#.#..#
#.#..#...#....#..#..#.#..#
#.#..########.#..#..#.#..#
#.#.................#....#
#.#####################..#
#........................#
##########################